Users not on PC

Znk - England | Zunaka
Carl-bot - Carl-bot
Creevey the Kitten - England | Creevey
Taibhse - Ireland | Relaxx
Zingan - Sweden | Zingan
Proto - Australia | Proto
CrazyTNT - Turkey in Asia | CrazyTNT
imperiaIist - Canada | Imperialist
GamerTito - USA | GamerTito
MEE6 - MEE6
Beriff - Russia | Beriff
danascus - Russia  | danascus
DISBOARD - DISBOARD
for91days - Spain | for91days
Laatikkoxx - Finland | Laatikkoxx
e m e r a l d - Norway | e m e r a l d
InviteManager - InviteManager
Pokécord - Pokécord
Mi - Greece | Mimi
Reaction Roles - Reaction Roles
Dofite - Russia | Dofite
brickadia bee - USA | ham.mp
Ottorium - Russia | Ottorium
EPEC Bot - OLD EPEC BOT
Joseph Joestar - Dominican Republic | Joseph
Hensdottír_ - Iceland | Hekla
KakyoMelon - Germany | Melone
Reapy - Germany | Reapy
Anonygold - Brazil | Anonygold
icelander - Iceland | Icelander
energy - England | energy
birbs - Mexico | birbs
Rouyfigy - Guatemala | Rouyfigy
cashmoney_bri - Netherlands | Cashmoney_bri
Mosta - Egypt | Mostafa
Groovy - Groovy
A̵͗̉r̴͋͐e̵͊͝4̸̽͠ - Romania | Are4
Game N Facts - USA | Game n facts
Rey - Algeria | Rey
FaZe Snacky - USA | Snacky
ثيو - Norway | ثيو
EpiCon - Germany | Epicon
Firestar - Ukraine | Firestar
RandomGuy - Morocco | RandomGuy
idontknowwut - Indonesia | idontknowwut
Aya La - Kazahkstan | Aya La
Tudorica - Romania | Tudorica
cho_hee - Germany | cho_hee
MinecraftClass - Philippines | MinecraftClass
AestheticBob - Phillippines | AestheticBob
RedHotBeast - Philippines | RedHotBeast
ExtraLarge150 - Philippines | XtraLarge
Pan That Shouldn't Exist - USA | Pan that shouldn't exist
maginnal buress - Philippines | SinisterMagister
estoniahuman - Estonia | estoniahuman
Bea - Brazil | Bea
๖̶̶̶ζ͜͡Piano Cat ☭ - Romania | ๖̶̶̶ζ͜͡Piano Cat ☭
àhmed - Morocco | àhmed
Shun Namiki - Canada | Shun Namiki
Xohn - Norway | Xohn
Rektoote - Latvia | Rektoote
E.P.E.C Bot - E.P.E.C Bot
Death - Australia | Death
The Incredible Hunk - Mexico | The Incredible Hunk
Forst phoenix - Forst phoenix
ROAR - USA | ROAR
Kuba - Poland | Kuba
Alastor - Indonesia | Alastor
